1111111111111
1001000000MC1
1P0C01011C001
10M011E000011
1111111111111
