11111111111111111111111111
1E1111M00000000C00000C0001
10100101001000000010010001
1010M10010100010M010010001
1P0000000C00C01000100000M1
11111111111111111111111111