1111111111111
10010000000C1
1P0C01011C001
100011E000011
1111111111111
